1111111111111
1001C00E000C1
1100011111001
10C0110000P01
1111111111111