1111111111111111111111111111111111
1E0000000000000C00000C000000000001
1010010100100000101001000000010101
1010010010101010001001000000010101
100000000C00C0000000000000000000C1
1E0000000000000C00000C000000000001
1010010100100000101001000000010101
1010010010101010001001000000010101
100000000C00C00000000000E0000000C1
1E0000000000000C00000C000000000001
1010010100100000101001000000010101
1010010010101010001001000000010101
100000000C00C0000000000000000000C1
1E0000P00000000C00000C000000000001
101001010010000E101001000000010101
1010010010101010001001000000010101
100000000C00C000000000000E000000C1
1E0000000000000C00000C000000000001
1010010100100000101001000000010101
1010010010101010001001000000010101
100000000C00C0000000000000000000C1
1E0000000000000C00000C000000000001
1010010100100000101001000000010101
1111111111111111111111111111111111
